................................................................................
................................................................................
................................................................................
................................................................................
................................................................................
.............@@...@@...@@...@@...@@...@@...@@...@@...@@...@@...@@...@@...@@.....
...............@@...@@...@@...@@...@@...@@...@@...@@...@@...@@...@@...@@...@@...
...............@@...@@...@@...@@...@@...@@...@@...@@...@@...@@...@@...@@...@@...
.............@@...@@...@@...@@...@@...@@...@@...@@...@@...@@...@@...@@...@@.....
................................................................................
................................................................................
..............@@...@@...@@...@@...@@...@@...@@...@@...@@...@@...@@...@@...@@....
................@@...@@...@@...@@...@@...@@...@@...@@...@@...@@...@@...@@...@@..
................@@...@@...@@...@@...@@...@@...@@...@@...@@...@@...@@...@@...@@..
..............@@...@@...@@...@@...@@...@@...@@...@@...@@...@@...@@...@@...@@....
................................................................................
................................................................................
..............@@...@@...@@...@@...@@...@@...@@...@@...@@...@@...@@...@@...@@....
................@@...@@...@@...@@...@@...@@...@@...@@...@@...@@...@@...@@...@@..
................@@...@@...@@...@@...@@...@@...@@...@@...@@...@@...@@...@@...@@..
..............@@...@@...@@...@@...@@...@@...@@...@@...@@...@@...@@...@@...@@....
................................................................................
................................................................................
................................................................................
................................................................................